##GeradorSenhas
source /etc/profile.d/rvm.sh
rvm use 2.5.1
alias gerarSenha="ruby /home/luis/scripts/geradorsenha/gerador_senha_newest.rb"
alias gerarSenhaUdemy="gerarSenha -d www.udemy.com -l $GMAIL -t 16 -s estudo"
alias gerarSenhaFacebook="gerarSenha -d www.facebook.com -l $HOTMAIL -t 16 -s social"
alias gerarSenhaCloudCampus="gerarSenha -d cursos.cloudcampus.cc -l $YAHOO -s estudo -t 16"
alias gerarSenhaB2sShare="gerarSenha -d www.b2s-share.com -l gust -t 16 -s entretenimento"
alias gerarSenhaTheRebels="gerarSenha -d therebels.us -l $USERNAME1 -t 16 -s entretenimento"
alias gerarSenhaSubmarino="gerarSenha  -d cliente.submarino.com.br -l $YAHOO -s compra -t 16"
alias gerarSenhaLinkedin="gerarSenha -d www.linkedin.com -l $YAHOO -t 16 -s social"
alias gerarSenhaBooking="gerarSenha -d www.booking.com -l $YAHOO -t 16 -s compra"
alias gerarSenhaSoftBlue="gerarSenha -d www.softblue.com.br -l $YAHOO -t 16 -s estudo"
alias gerarSenhaPagSeguro="gerarSenha -d pagseguro.uol.com.br -l $YAHOO -s compra -t 16"
alias gerarSenhaAwsAmazon="gerarSenha -d signin.aws.amazon.com -l $IFF -t 16 -s compra"
alias gerarSenhaTrello="gerarSenha -d trello.com -l $GMAIL -t 16 -s social"
alias gerarSenhaCpTurbo="gerarSenha  -d www.cpturbo.org -l $USERNAME1 -t 16 -s entretenimento"
alias gerarSenhaWalmart="gerarSenha -d www.walmart.com.br -l $YAHOO -t 16 -s compra"
alias gerarSenhaNetFlix="gerarSenha -d www.netflix.com -l $YAHOO -t 8 -s entretenimento"
alias gerarSenhaVerTV="gerarSenha -d minha.vertv.com.br -l $GMAIL -t 16 -s compra"
alias gerarSenhaClickBus="gerarSenha -d www.clickbus.com.br -l $YAHOO -s compra -t 16"
alias gerarSenhaAmericanas="gerarSenha -d www.americanas.com.br -l $YAHOO -s compra -t 16"
alias gerarSenhaPontoFrio="gerarSenha -d carrinho.pontofrio.com.br -l $YAHOO -s compra -t 16"
alias gerarSenhaSigepe="gerarSenha -d sso.gestaodeacesso.planejamento.gov.br -l $CPF -s trabalho -t 16"
alias gerarSenhaDominos="gerarSenha -d delivery.dominos.com.br -l $GMAIL -t 16 -s compra"
alias gerarSenhaNetAcad="gerarSenha -d www.netacad.com -l $IFF -t 16 -s estudo"
alias gerarSenhaAmazon="gerarSenha -d www.amazon.com.br -l $IFF -t 16 -s compra"
alias gerarSenhaAirBnb="gerarSenha -d www.airbnb.com.br -l $GMAIL -t 16 -s compra"
alias gerarSenhaWorkana="gerarSenha -d www.workana.com -l $GMAIL -t 16 -s compra"
alias gerarSenhaUnimedMarcacao="gerarSenha -d marcacao.campos.unimed.com.br:8080 -l $CPF -t 6 -s saude -c ln"
alias gerarSenhaCasasBahia="gerarSenha -d carrinho.casasbahia.com.br -l $YAHOO -t 16 -s compra"
alias gerarSenhaUpInside="gerarSenha -d www.upinside.com.br -l $GMAIL -t 16 -s estudo"
alias gerarSenhaHotmailLive="gerarSenha -d login.live.com -l $HOTMAIL -t 16 -s comunicacao"
alias gerarSenhaQConcursos="gerarSenha -d accounts.qconcursos.com -l $GMAIL -t 16 -s estudo"
alias gerarSenhaDuolingo="gerarSenha -d www.duolingo.com -l $GMAIL -t 16 -s estudo"
alias gerarSenhaLyricsTraining="gerarSenha -d lyricstraining.com -l $GMAIL -t 16 -s estudo"
alias gerarSenhaBabbel="gerarSenha -d accounts.babbel.com -l $GMAIL -t 16 -s estudo"
alias gerarSenhaIdIFF="gerarSenha -d id.iff.edu.br -l 2266283 -t 16 -s trabalho5"
# alias gerarSenhaWebMailIFF="gerarSenha -d webmail2.iff.edu.br -l $USERNAME3 -t 16 -s trabalho"
alias gerarSenhaRotaDosConcursos="gerarSenha -d rotadosconcursos.com.br -l $GMAIL -t 16 -s estudo"
alias gerarSenhaIFood="gerarSenha -d www.ifood.com.br -l $GMAIL -t 16 -s compra"
alias gerarSenhaUsaLearns="gerarSenha -d www.usalearns.org -l $GMAIL -t 16 -s estudo"
alias gerarSenhaBrFiles="gerarSenha -d brfiles.com -l $USERNAME1 -t 16 -s entretenimento"
alias gerarSenhaIEstudos="gerarSenha -d www.iestudos.com.br -l $GMAIL -t 16 -s estudo"
alias gerarSenhaProvasTI="gerarSenha -d www.provasdeti.com.br -l $GMAIL -t 16 -s estudo"
alias gerarSenhaBlogStato="gerarSenha -d www.stato.blog.br -l $IFF -t 16 -s estudo"
alias gerarSenhaSpotify="gerarSenha -d open.spotify.com -l $USERNAME2 -t 16 -s entretenimento"
alias gerarSenhaGloboPlay="gerarSenha -d login.globo.com -l $GMAIL -t 15 -s entretenimento"
alias gerarSenhaDticCampos="gerarSenha -d dtic-campos.iff.edu.br -l $USERNAME3 -t 16 -s trabalho"
alias gerarSenhaDeezer="gerarSenha -d www.deezer.com -l $GMAIL -t 16 -s entretenimento"
alias gerarSenhaPrimeCursos="gerarSenha -d www.primecursos.com.br -l $GMAIL -t 16 -s estudo -c Sln"
alias gerarSenhaVectr="gerarSenha -d vectr.com -l $USERNAME2 -t 16 -s estudo"
alias gerarSenhaPackPub="gerarSenha -d www.packtpub.com -l $GMAIL -t 16 -s estudo"
alias gerarSenhaQuora="gerarSenha -d www.quora.com -l $GMAIL -t 16 -s estudo"
alias gerarSenhaSafariBooksOnline="gerarSenha -d www.safaribooksonline.com -l $GMAIL -t 16 -s estudo"
alias gerarSenhaScribd="gerarSenha -d www.scribd.com -l $GMAIL -t 16 -s estudo"
alias gerarSenha4Shared="gerarSenha -d www.4shared.com -l $GMAIL -t 16 -s entretenimento"
alias gerarSenhaEscolaFormacaoIFF="gerarSenha -d escoladeformacao.iff.edu.br -l 2266283 -t 16 -s trabalho"
alias gerarSenhaSebraeAtendimento="gerarSenha -d atendimento.sebrae-sc.com.br -l $USERNAME3 -t 16 -s estudo"
alias gerarSenhaBitBucket="gerarSenha -d bitbucket.org -l $GMAIL -t 16 -s estudo"
alias gerarSenhaAlfaConcursos="gerarSenha -d www.alfaconcursos.com.br -l $GMAIL -t 16 -s estudo"
alias gerarSenhaTumblr="gerarSenha -d www.tumblr.com -l $GMAIL -t 12 -s entretenimento"
alias gerarSenhaSebraeAtendimento="gerarSenha -d atendimento.sebrae-sc.com.br -l $USERNAME3 -t 12 -s estudo"
alias gerarSenhaSololearn="gerarSenha -d www.sololearn.com -l $GMAIL -t 16 -s estudo"
alias gerarSenhaEVG="gerarSenha -d evg.gov.br -l $IFF -t 16 -s trabalho"
alias gerarSenhaDescomplica="gerarSenha -d descomplica.com.br -l $GMAIL -t 16 -s estudo"
alias gerarSenhaSlack="gerarSenha -d slack.com -l $GMAIL -t 16 -s estudo"
alias gerarSenhaPowtoon="gerarSenha -d www.powtoon.com -l $GMAIL -t 16 -s estudo"
alias gerarSenhaUniqueBox="gerarSenha -d www.uniquebox.com.br -l $GMAIL -t 13 -s compra"
alias gerarSenhaPowtoon="gerarSenha -d www.powtoon.com -l $GMAIL -t 16 -s estudo"
alias gerarSenhaOys="gerarSenha -d oys.com.br -l $GMAIL -t 8 -s estudo"
alias gerarSenhaEsecurity="gerarSenha -d cursos.esecurity.com.br -l $YAHOO -t 16 -s estudo"
alias gerarSenhaQuatUX="gerarSenha -d www.quant-ux.com -l $GMAIL -t 16 -s estudo"
alias gerarSenhaGrupoGen="gerarSenha -d www.grupogen.com.br -l $GMAIL -t 13 -s estudo"
alias gerarSenhaOndeFuiRoubado="gerarSenha -d www.ondefuiroubado.com.br -l $GMAIL -t 12 -s outros"
alias gerarSenhaUdacity="gerarSenha -d udacity.com -l $GMAIL -t 16 -s estudo"
alias gerarSenhaItalk="gerarSenha -d www.italki.com -l $GMAIL -t 16 -s estudo"
alias gerarSenhaGranCursosOline="gerarSenha -d www.grancursosonline.com.br -l $GMAIL -t 15 -s estudo"
alias gerarSenhaReceitaFederal="gerarSenha -d www.receita.fazenda.gov.br -l $CPF -c Sln -t 14"
alias gerarSenhaFreeImages="gerarSenha -d pt.freeimages.com -l $USERNAME2 -t 16 -s estudo"
alias gerarSenhaCoreIPTV="gerarSenha -d central.coreiptv.me -l $GMAIL -t 16 -s entretenimento"
alias gerarSenhaAwsGmailAmazon="gerarSenha -d signin.aws.amazon.com -l $GMAIL -t 19 -s compra"
alias gerarSenhaAppResumerPlay="gerarSenha -d appresumerplay.com -l luisgustavo@gmail.com -t 16 -s estudo"
alias gerarSenhaShoptime="gerarSenha -d cliente.shoptime.com.br -l $GMAIL -t 20 -s compra"
alias gerarSenhaInstitutoAcesso="gerarSenha -d concursos.institutoacesso.org.br -l $GMAIL -t 16 -s concurso"
alias gerarSenhaDevMedia="gerarSenha -d www.devmedia.com.br -l $GMAIL -c Sln -t 16 -s estudo"
alias gerarSenhaTecConcursos="gerarSenha -d www.tecconcursos.com.br -l $GMAIL -t 16 -s estudo"
alias gerarSenhaDankiCode="gerarSenha -d cursos.dankicode.com -l $GMAIL -t 16 -s estudo"
alias gerarSenhaCursoCompletoJava="gerarSenha -d cursocompletoemjsfcomprimeface.club.hotmart.com -l $GMAIL -t 16 -s estudo"
alias gerarSenhaSumicity="gerarSenha -d camposdosgoytacazes.sumicity.com.br -l $CPF -t 16 -s entretenimento"
alias gerarSenhaRNPEsr="gerarSenha -d esr.rnp.br -l $USERNAME3 -t 16 -s estudo"
alias gerarSenhaEstrategia="gerarSenha -d www.estrategiaconcursos.com.br -l $GMAIL -t 16 -s estudo2"
alias gerarSenhaPasseiDireto="gerarSenha -d www.passeidireto.com -l $HOTMAIL -t 16 -s estudo"
alias gerarSenhaHPCTreinamentos="gerarSenha -d hpc.myedools.com -l $GMAIL -t 13 -s estudo"
alias gerarSenhaRedacaoOnline="gerarSenha -d redacaonline.com.br -l $GMAIL -t 15 -s estudo"
alias gerarSenhaBinary="gerarSenha -d www.binary.com -l $GMAIL -t 18 -s compra"
alias gerarSenhaPaypal="gerarSenha -d www.paypal.com -l $GMAIL -t 16 -s compra2"
alias gerarSenhaBitly="gerarSenha -d bitly.com -l $USERNAME2 -t 10 -s trabalho"
alias gerarSenhaCampusParty="gerarSenha -d campuse.ro -l $USERNAME2 -t 16 -s estudo"
alias gerarSenhaVisaCheckout="gerarSenha -d www.visa.com.br -l $GMAIL -t 16 -s compra3"
alias gerarSenhaOrigamid="gerarSenha -d www.origamid.com -l $GMAIL -t 16 -s estudo"
alias gerarSenhaBibliotecaCatolica="gerarSenha -d www.bibliotecacatolica.com.br -l $GMAIL -t 16 -s espiritualidade"
